091082540
300001000
000000020
079000100
000970006
052040070
200006007
040020380
900300000