000050030
060008007
071009050
007000008
800106003
600080500
050200941
100800000
020040000