350108070
000000200
060005090
081920306
006000700
503006980
040580100
007000000
010009068