300060548
406083700
008009000
901030082
600004100
003108090
000095003
230706850
860000900