720300600
000420008
013050720
001008502
650030070
400910800
000070159
930046000
180002030