005190203
804003000
009700805
001007000
706085039
080009076
002370600
490800320
300001054