001690485
578420060
600005700
290046500
804010976
100509040
405061097
003908620
902030800