076021903
421309076
000700080
040900208
130800604
205146090
390007000
710203469
500408730