340960020
001300594
907024060
019600308
008040200
403798610
076405002
002800050
094036781