074069005
610405927
900010600
480056301
100030009
360071082
500008096
741603050
800027130