000890401
439700280
108504600
340980002
060205090
290013067
604057008
072008153
080120700