007004002
194285637
060300080
010526948
425009001
006007050
250003090
340902175
600058300