469038152
300002000
020096804
005210603
180079420
034060001
802051006
040600578
053480010