008000002
349201708
100583960
030127490
900000003
467908210
010005007
596402381
700016500