002348907
086900230
390060050
108093000
609520483
050700106
007100008
820006310
401859602