020400190
810506403
074180020
007013052
180040067
502908004
201060780
940051200
030890041