300040200
250003740
004051080
030060007
040807000
060005420
700028600
090300052
420010070