005090370
006031002
023006090
002008001
109304007
400005908
290500680
300109000
050080710