790200060
600081300
001009450
042500708
008400600
907008540
010900070
006010030
020605084