003004056
904607300
008005100
090208610
360000080
002106090
006000000
005982701
180700240