003010602
048600050
500000000
900005230
006030100
070200000
002000004
000028590
109070800