030005190
400370080
600000000
201030000
580000906
000010300
052400079
008002000
000700400