800000000
270100050
000079063
080000304
050604000
310007500
400026000
030800072
500090000