280100070
000006500
090008040
031400209
009000700
802009430
060800000
007000050
010024093