000060070
000008003
734005060
003000008
800409007
900001600
060100520
400800001
010020000