006900103
010003000
008001006
009005001
007040900
040008007
001050700
080400310
300009062