000080000
950000086
008056010
040000203
080123000
270000800
300091020
020400059
800060000