080010070
006098403
039006010
003000008
840932007
200005130
018500640
900800005
050340001