510004200
600190050
800050710
702410005
450000308
000028007
047680003
905007000
000900672