080007000
690004031
500091480
040006702
030802900
750040300
204068070
070400096
300010004