700034006
103700480
600500900
200380004
096405031
005062007
001007048
074018602
500400000