004052108
027100400
900070060
050709040
081040500
400800310
070090002
200007930
503260700